2 4
0 0 0 1 1 0
1 0 0 1 0 0
2 0 0 1 0 1
3 0 1 1 0 1
0 1 1 0 1 1
1 1 1 0 1 1
2 1 0 1 1 1
3 1 0 1 0 0
START
1
0 0 l
GOAL
4
1 1 u
1 1 l
1 1 d
1 1 r
